"a" = (/turf/unsimulated/wall,/area/winterstorm/mystery_zone)
"b" = (/obj/travellocation,/turf/simulated/floor/dirt,/area/winterstorm/mystery_zone)
"c" = (/turf/genturf,/area/winterstorm)
"d" = (/turf/unsimulated/wall/ice,/area/winterstorm)
"e" = (/turf/simulated/floor/snow,/area/winterstorm)
"f" = (/turf/simulated/wall/iron,/area/winterstorm/military_barracks)
"g" = (/turf/simulated/floor/tiled,/area/winterstorm/military_barracks)
"h" = (/turf/simulated/floor/dirt,/area/winterstorm)
"i" = (/turf/simulated/floor/wood,/area/winterstorm/military_barracks)
"j" = (/obj/machinery/door/window/southright,/turf/simulated/floor/carpet,/area/winterstorm/military_barracks)
"k" = (/obj/machinery/door/window/westleft,/turf/simulated/floor/carpet,/area/winterstorm/military_barracks)
"l" = (/obj/machinery/door/window/westleft,/turf/simulated/floor/wood,/area/winterstorm/military_barracks)
"m" = (/obj/machinery/door/window/northright,/turf/simulated/floor/carpet,/area/winterstorm/military_barracks)
"n" = (/obj/machinery/door/window/northleft,/turf/simulated/floor/carpet,/area/winterstorm/military_barracks)
"o" = (/obj/machinery/door/window/westleft,/turf/simulated/floor/tiled,/area/winterstorm/military_barracks)
"p" = (/obj/structure/stairs/south,/turf/simulated/floor/wood,/area/winterstorm/military_barracks)
"q" = (/turf/simulated/open,/area/winterstorm/military_barracks)
"r" = (/turf/simulated/floor/snow,/area/winterstorm/military_barracks)
"s" = (/obj/machinery/door/window/southleft,/turf/simulated/floor/carpet,/area/winterstorm/military_barracks)
"t" = (/obj/structure/ladder/up,/turf/simulated/floor/tiled,/area/winterstorm/military_barracks)
"u" = (/obj/travellocation,/turf/simulated/floor/snow,/area/winterstorm/mystery_zone)
"v" = (/obj/machinery/door/window/westright,/turf/simulated/floor/carpet,/area/winterstorm/military_barracks)
"w" = (/obj/machinery/door/window/eastleft,/turf/simulated/floor/carpet,/area/winterstorm/military_barracks)
"x" = (/obj/machinery/door/window/eastright,/turf/simulated/floor/carpet,/area/winterstorm/military_barracks)
"y" = (/turf/simulated/floor/carpet,/area/winterstorm/military_barracks)
"z" = (/turf/simulated/floor/dirt,/area/winterstorm/military_barracks)
"A" = (/obj/structure/stairs/north,/turf/simulated/floor/tiled,/area/winterstorm/military_barracks)
"B" = (/obj/travellocation{id = "34eastwest4"},/turf/simulated/floor/snow,/area/winterstorm)
"C" = (/obj/travellocation{id = "34eastwest5"},/turf/simulated/floor/snow,/area/winterstorm)
"D" = (/obj/travellocation{id = "34eastwest6"},/turf/simulated/floor/snow,/area/winterstorm)
"E" = (/obj/travellocation{id = "34eastwest7"},/turf/simulated/floor/snow,/area/winterstorm)
"F" = (/turf/simulated/open,/area/winterstorm)
"G" = (/obj/effect/landmark/terrain_generator,/turf/unsimulated/wall,/area/winterstorm/mystery_zone)
"H" = (/obj/travellocation{id = "13northsouth1"},/turf/simulated/floor/snow,/area/winterstorm)
"I" = (/obj/travellocation{id = "13northsouth2"},/turf/simulated/floor/snow,/area/winterstorm)
"J" = (/obj/travellocation{id = "13northsouth3"},/turf/simulated/floor/snow,/area/winterstorm)
"K" = (/obj/travellocation{id = "13northsouth4"},/turf/simulated/floor/snow,/area/winterstorm)

(1,1,1) = {"
aaaaaaaaaaaaaaaaaaaaaaaaaaaaaaaaaaaaaaaaaaaaaaaaaaaaaaaaaaaaaaaaaaaaaaaabbbbaaaaaaaaaaaaaaaaaaaaaaaaaaaaaaaaaaaaaaaaaaaaaaaaaaaaaaaaaaaaaaaaaaaaaaaaaa
acccccccccccccccccccccccccccccccccccccccccccccccccccccccccccccccccccccccccccccccccccccccccccccccccccccccccccccccccccccccccccccccccccccccccccccccccccda
acccccccccccccccccccccccccccccccccccccccccccccccccccccccccccccccccccccccccccccccccccccccccccccccccccccccccccccccccccccccccccccccccccccccccccccccccccda
acccccccccccccccccccccccccccccccccccccccccccccccccccccccccccccccccccccccccccccccccccccccccccccccccccccccccccccccccccccccccccccccccccccccccccccccccccda
acccccccccccccccccccccccccccccccccccccccccccccccccccccccccccccccccccccccccccccccccccccccccccccccccccccccccccccccccccccccccccccccccccccccccccccccccccda
accccccccccccccccccccccccccccccccccccccccccccccccccccccccccccccccccccccccccccccccccccccccccccccccccccccccccccccccccccccccccccccccccccccccccccccccccdda
accccccccccccccccccccccccccccccccccccccccccccccccccccccccccccccccccccccccccccccccccccccccccccccccccccccccccccccccccccccccccccccccccccccccccccccccccdda
accccccccccccccccccccccccccccccccccccccccccccccccccccccccccccccccccccccccccccccccccccccccccccccccccccccccccccccccccccccccccccccccccccccccccccccccccdda
acccccccccccccccccccccccccccccccccccccccccccccccccccccccccccccccccccccccccccccccccccccccccccccccccccccccccccccccccccccccccccccccccccccccccccccccccddda
acccccccccccccccccccccccccccccccccccccccccccccccccccccccccccccccccccccccccccccccccccccccccccccccccccccccccccccccccccccccccccccccccccccccccccccccccddda
accccccccccccccccccccccccccccccccccccccccccccccccccccccccccccccccccccccccccccccccccccccccccccccccccccccccccccccccccccccccccccccccccccccccccccccccdddda
accccccccccccccccccccccccccccccccccccccccccccccccccccccccccccccccccccccccccccccccccccccccccccccccccccccccccccccccccccccccccccccccccccccccccccccccdddda
accccccccccccccccccccccccccccccccccccccccccccccccccccccccccccccccccccccccccccccccccccccccccccccccccccccccccccccccccccccccccccccccccccccccccccccccdddda
accccccccccccccccccccccccccccccccccccccccccccccccccccccccccccccccccccccccccccccccccccccccccccccccccccccccccccccccccccccccccccccccccccccccccccccccdddda
acccccccccccccccccccccccccccccccccccccccccccccccccccccccccccccccccccccccccccccccccccccccccccccccccccccccccccccccccccccccccccccccccccccccccccccccddddda
accccccccccccccccccccccccccccccccccccccccccccccccccccccccccccccccccccccccccccccccccccccccccccccccccccccccccccccccccccccccccccccccccccccccccccccdddddda
accccccccccccccccccccccccccccccccccccccccccccccccccccccccccccccccccccccccccccccccccccccccccccccccccccccccccccccccccccccccccccccccccccccccccccccdddddda
accccccccccccccccccccccccccccccccccccccccccccccccccccccccccccccccccccccccccccccccccccccccccccccccccccccccccccccccccccccccccccccccccccccccccccccdddddda
acccccccccccccccccccccccccccccccccccccccccccccccccccccccccccccccccccccccccccccccccccccccccccccccccccccccccccccccccccccccccccccccccccccccccccccddddddda
acccccccccccccccccccccccccccccccccccccccccccccccccccccccccccccccccccccccccccccccccccccccccccccccccccccccccccccccccccccccccccccccccccccccccccccddddddda
acccccccccccccccccccccccccccccccccccccccccccccccccccccccccccccccccccccccccccccccccccccccccccccccccccccccccccccccccccccccccccccccccccccccccccccddddddda
acccccccccccccccccccccccccccccccccccccccccccccccccccccccccccccccccccccccccccccccccccccccccccccccccccccccccccccccccccccccceeeeeeeeeeeeeeeecccccddddddda
acccccccccccccccccccccccccccccccccccccccccccccccccccccccccccccccccccccccccccccccccccccccccccccccccccccccccccccccccccccccceeeeeeeeeeeeeeeecceeeddddddda
acccccccccccccccccccccccccccccccccccccccccccccccccccccccccccccccccccccccccccccccccccccccccccccccccccccccccccccccccccccccceeeeeeeeeeeeeeeeceeeeddddddda
acccccccccccccccccccccccccccccccccccccccccccccccccccccccccccccccccccccccccccccccccccccccccccccccccccccccccccccccccccccccceeeeeeffffeeeeeeeeeeeddddddda
accccccccccccccccccccccccccccccccccccccccccccccccccccccccccccccccccccccccccccccccccccccccccccccccccccccccceeeeeeeeeeeeeeeeeeeeefggfeeeeeeeeeeeddddddda
accccccccccccccccccccccccccccccccccccccccccccccccccccccccccccccccccccccccccccccccccccccccccccccccccccccccceeeeeeeeeeeeeeeeeeeeefgggfeeeeeehheeddddddda
accccccccccccccccccccccccccccccccccccccccccccccccccccccccccccccccccccccccccccccccccccccccccccccccccccccccceeeeeeeeeeeeeeeeeeeeefgggfeeeeehhhhhddddddda
accccccccccccccccccccccccccccccccccccccccccccccccccccccccccccccccccccccccccccccccccccccccccccccccccccccccceeeeeeeeeeeeeeeeefffffggggfeeeehhhhhddddddda
accccccccccccccccccccccccccccccccccccccccccccccccccccccccccccccccccccccccccccccccccccccccccccccccccccccccceeeeeeeeeeeeeeeeefiiifggggfeeeehhhhhddddddda
accccccccccccccccccccccccccccccccccccccccccccccccccccccccccccccccccccccccccccccccccccccccccccccccccccccccceeeeeeeeeeeeeeeeefiiifgggggfeehhhhhhddddddda
accccccccccccccccccccccccccccccccccccccccccccccccccccccccccccccccccccccccccccccccccccccccccccccccccccccccceeeeeeeeeeeeeeeeefiiifgggggfehhhhhhhddddddda
accccccccccccccccccccccccccccccccccccccccccccccccccccccccccccccccccccccccccccccccccccccccccccccccccccccccceeeeeeffffffffffffiiiffffjffehhhhhhhhdddddda
accccccccccccccccccccccccccccccccccccccccccccccccccccccccccccccccccccccccccccccccccccccccccccccccccccccccceeeefffggfiiiiiiiiiiifgggggfehhhhhhhhdddddda
accccccccccccccccccccccccccccccccccccccccccccccccccccccccccccccccccccccccccccccccccccccccccccccccccccccccceeeekgkggfiiiiiiiiiiifgggggfehhhhhhhhdddddda
accccccccccccccccccccccccccccccccccccccccccccccccccccccccccccccccccccccccccccccccccccccccccccccccccccccccceeeefffggfiiiiiiiiiiifgggggfeehhhhhhhdddddda
accccccccccccccccccccccccccccccccccccccccccccccccccccccccccccccccccccccccccccccccccccccccccccccccccccccccceeeekgkggliiiiiiiiiiifgggggfeeehhhhhhdddddda
accccccccccccccccccccccccccccccccccccccccccccccccccccccccccccccccccccccccccccccccccccccccccccccccccccccccceeeefffggfiiiiiiiiiiifgggggfeeeeehhheeddddda
accccccccccccccccccccccccccccccccccccccccccccccccccccccccccccccccccccccccccccccccccccccccccccccccccccccccceeeeeefggfiiiiiiiiiiifgggggfeeeeeeeeeeddddda
accccccccccccccccccccccccccccccccccccccccccccccccccccccccccccccccccccccccccccccccccccccccccccccccccccccccceeeeeefggfffmffffffnffgggggfeeeeeeeeecddddda
accccccccccccccccccccccccccccccccccccccccccccccccccccccccccccccccccccccccccccccccccccccccccccccccccccccccceeeeeefggfiiiiifiiiiifgggggfeeeeeeeecccdddda
accccccccccccccccccccccccccccccccccccccccccccccccccccccccccccccccccccccccccccccccccccccccccccccccccccccccceeeeeefggfiiiiifiiiiifgggggfeeeeeccccccdddda
accccccccccccccccccccccccccccccccccccccccccccccccccccccccccccccccccccccccccccccccccccccccccccccccccccccccceeeeeefggfffffffffffffgggggfeeeecccccccdddda
accccccccccccccccccccccccccccccccccccccccccccccccccccccccccccccccccccccccccccccccccccccccccccccccccccccccceeeeeefggogggggggggggogggggfeeeccccccccdddda
accccccccccccccccccccccccccccccccccccccccccccccccccccccccccccccccccccccccccccccccccccccccccccccccccccccccceeeeeefggfgggggggggggfgggggfeeeccccccccdddda
accccccccccccccccccccccccccccccccccccccccccccccccccccccccccccccccccccccccccccccccccccccccccccccccccccccccceeeeeefggfgggggggggggfgggggfeeeccccccccdddda
accccccccccccccccccccccccccccccccccccccccccccccccccccccccccccccccccccccccccccccccccccccccccccccccccccccccceeeeeefggfgggggggggggfggggfeeeeccccccccdddda
accccccccccccccccccccccccccccccccccccccccccccccccccccccccccccccccccccccccccccccccccccccccccccccccccccccccceeeeeeffffffffffffffffffffeeeeeccccccccdddda
accccccccccccccccccccccccceeeeeeeeeeeeeeeeeeeeeeeeeeeeeeeeeeeeeeeeeeeeeeeeeeeeeeeeeeeeeeeeeeeeeeeccccccccceeeeeeeeeeeeeeeeeeeeeeeeeeeeeeeccccccccdddda
accccccccccccccccccccccccceeeeeeeeeeeeeeeeeeeeeeeeeeeeeeeeeeeeeeeeeeeeeeeeeeeeeeeeeeeeeeeeeeeeeeeccccccceeeeeeeeeeeeeeeeeeeeeeeeeeeeeeeeeccccccccdddda
accccccccccccccccccccccccceeeeeeeeeeeeeeeeeeeeeeeeeeeeeeeeeeeeeeeeeeeeeeeeeeeeeeeeeeeeeeeeeeeeeeeecccccceeeeeeeeeeeeeeeeeeeeeeeeeeeeeeeeeccccccccdddda
accccccccccccccccccccccccceeeeeeeeeeeeeeeeeeeeeeeeeeeeeeeeeeeeeeeeeeeeeeeeeeeeeeeeeeeeeeeeeeeeeeeeeeecceeeeeeeeeeeeeeeeeeeeeeeeeeeeeeeeeeccccccccdddda
accccccccccccccccccccccccceeeeeeeeeeeeeeeeeeeeeeeeeeeeeeeeeeeeeeeeeeeeeeeeeeeeeeeeeeeeeeeeeeeeeeeeeeeeeeeeeeeeeeeeeeeeeeeeeeeeeeeeeeeeeeeccccccccdddda
accccccccccccccccccccccccceeeeeeeeeeeeeeeeeeeeeeeeeeeeeeeeeeeeeeeeeeeeeeeeeeeeeeeeeeeeeeeeeeeeeeeeeeeeeeeeeeeeeeeeeeeeeeeeeeeeeeeeeeeeeeecccccccddddda
accccccccccccccccccccccccceeeeeeeeeeeeeeeeeeeeeeeeeeeeeeeeeeeeeeeeeeeeeeeeeeeeeeeeeeeeeeeeeeeeeeeeeeeeeeeeeeeeeeccccccccccccccccccccccccccccccccddddda
accccccccccccccccccccccccceeeeeeefffffffffffffffffffffffffffffffffffffffffffffffffffffffeeeeeeeeeeeeeeeeeeeeeeeecccccccccccccccccccccccccccccccdddddda
accccccccccccccccccccccccceeeeeeefgggggggggggggfggggggfgggggfgggggggggggggfgggggfgggiiifeeeeeeeeeeeeeeeeeeeeeeeeccccccccccccccccccccccccccccccddddddda
accccccccccccccccccccccccceeeeeeefgggggggggggiifggggggfgggggfgggggggggggggfgggggfgggiiifeeeeeeeeeeeeeeeeeeeeeeeecccccccccccccccccccccccccccccdddddddda
accccccccccccccccccccccccceeeeeeefggggggggggfppfggggggfgggggfgggggggggggggfgggggfgggfiifeeeeeeeeeeeeeeeeeeeeeeeecccccccccccccccccccccccccccdddddddddda
accccccccccccccccccccccccceeeeeeefggggggggggffffggggggfgggggfgggggggggggggfgggggfgggfqqfeeeeeeeeeeeeeeeeeeeeeeeeccccccccccccccccccccccccccddddddddddda
accccccccccccccccccccccccceeeeeeefggggggggggffffggggggfgggggfgggggggggggggfgggggfgggfrrfeeeeeeeeeeeeeeeeeeeeeeeeccccccccccccccccccccccccccddddddddddda
accccccccccccccccccccccccceeeeeeefggggggggggggggggggggfggffffgggggggggggggfgggggfgggffffeeeeeeeeeeeeeeeeeeeeeeeeccccccccccccccccccccccccddddddddddddda
accccccccccccccccccccccccceeeeeeefgggggggggggggggggggggggfggfgggggggggggggfgggggfggggggfeeeeeeeeeeeeeeeeeeeeeeeecccccccccccccccccccccccdddddddddddddda
accccccccccccccccccccccccceeeeeeefgggggggggggggggggggggggfggfgggggggggggggfgggggfggggggfeeeeeeeeeeeeeeeeeeeeeeeeccccccccccccccccccccccddddddddddddddda
accccccccccccccccccccccccceeeeeeefffffggfffffggffffffffggfggfgggggggggggggfgggggfggggggfeeeeeeeeeeeeeeeeeeeeeeeeccccccccccccccccccccccddddddddddddddda
accccccccccccccccccccccccceeeeeeefgggfggfgggfggfggggggfggfggfgggggggggggggfgggggfffffggfeeeeeeeeeeeeeeeeeeeeeeeecccccccccccccccccccccdddddddddddddddda
accccccccccccccccccccccccceeeeeeefggggggggggfggfgggggggggggggggggggggggggggggggggggggggfeeeeeeeeeeeeeeeeeeeeeeeeccccccccccccccccccccddddddddddddddddda
accccccccccccccccccccccccceeeeeeefgggfggfgggfggfggggggfggggggggggggggggggggggggggggggggfeeeeeeeeeeeeeeeeeeeeeeeeccccccccccccccccccccddddddddddddddddda
accccccccccccccccccccccccceeeeeeefffffggfffffsjfffffffffffsjffffffffffffffffffffffffffffeeeeeeeeeeeeeeeeeeeeeeeeccccccccccccccccccccddddddddddddddddda
accccccccccccccccccccccccceeeeeeefggggggggggfhhheeeeeeeeeehhheeeeeeeeeeeeeeeeeeeeeeeeeeeeeeeeeeeeeeeeeeeeeeeeeeeccccccccccccccccccccddddddddddddddddda
accccccccccccccccccccccccceeeeeeefggggggggggfhhheeeeeeeeeeehhheeeeeeeeeeeeeeeeeeeeeeeeeeeeeeefffffffffffeeeeeeeecccccccccccccccccccccdddddddddddddddda
accccccccccccccccccccccccceeeeeeefgggfggfgggfehhheeeeeeeeehhheeeeeeeeeeeeeeeeeeeeeeeeeeeeeeeefggtggggggfeeeeeeeeccccccccccccccccccccddddddddddddddddda
accccccccccccccccccccccccceeeeeeefffffggfffffeeehhhheeeeeehhheeeeeeeeeeeeeeeeeeeeeeeeeeeeeeeefgggggggggfeeeeeeeeccccccccccccccccccccddddddddddddddddda
accccccccccccccccccccccccceeeeeeefgggfggfgggfeeeehhhheeeeehhheeeeeeeeeeeeeeeeeeeeeeeeeeeeeeeefgggggggggfeeeeeeeeccccccccccccccccccccddddddddddddddddda
uccccccccccccccccccccccccceeeeeeefggggggggggfeeeeeehhhhheehheeeeeeeeeeeeeeeeeeeeeeeeeeeeehhhhggggggggggfeeeeeeeeccccccccccccccccccccddddddddddddddddda
uccccccccccccccccccccccccceeeeeeefggggggggggfeeeeeeeehhheehhehehhehhheeeeeeehhhhehhhhhhhhhhhhggggggggggfeeeeeeeecccccccccccccccccccccdddddddddddddddda
uccccccccccccccccccccccccceeeeeeefgggfggfgggfeeeeeeeeeehhhhhhhhhhhhhhhhhhhhhhhhhhhhhhhhhhhhhhggggggggggfeeeeeeeeccccccccccccccccccccddddddddddddddddda
uccccccccccccccccccccccccceeeeeeefgggfggfgggfeeeeeeeeeeehhhhhhhhhhhhhhhhhhhhhhhhhhhhhhhhhhhhhggggggggggfeeeeeeeecccccccccccccccccccccdddddddddddddddda
accccccccccccccccccccccccceeeeeeefgggfggfgggfeeeeeeeeeeehhhhhhhhhhhhhhheehehhheeehheehhhheeeefgggggggggfeeeeeeeecccccccccccccccccccccdddddddddddddddda
accccccccccccccccccccccccceeeeeeefgggfggfgggfiiiiiiiiiihhheeeeeeeeeeeeeeeeeeeeeeeeeeehhhhheeefgggggggggfeeeeeeeecccccccccccccccccccccdddddddddddddddda
accccccccccccccccccccccccceeeeeeefgggfggfgggfiiiiiiiiiiiiieeeeeeeeeeeeeeeeeeeeeeeeeeehhhhheeefgggggggggfeeeeeeeeccccccccccccccccccccccddddddddddddddda
accccccccccccccccccccccccceeeeeeefgggfggfgggfiiiiiiiiiiiiieeeeeeeeeeeeeeeeeeeeeeeeeeeehhhheeefgggggggggfeeeeeeeeccccccccccccccccccccccddddddddddddddda
accccccccccccccccccccccccceeeeeeefffffggfffffiiiiiiiiiiiiieeeeeeeeeeeeeeeeeeeeeeeeeeeehhhheeefffffffffffeeeeeeeecccccccccccccccccccccccdddddddddddddda
accccccccccccccccccccccccceeeeeeefgggfggfgggfffffiiiiiiiiiiiiieeeeeeeeeeeeeeeeeeeeeeeehhhheeeeeeeeeeeeeeeeeeeeeecccccccccccccccccccccccdddddddddddddda
accccccccccccccccccccccccceeeeeeefgggfggfgggfqqqfiiiiiiiiiiiiieeeeeeeeeeeeeeeeeeeeeeeeehhhheeeeeeeeeeeeeeeeeeeeecccccccccccccccccccccccdddddddddddddda
accccccccccccccccccccccccceeeeeeefggggggggggfqqqfiiiiiiiiiiiiieeeeeeeeeeeeeeeeeeeeeeeeehhhheeeeeeeeeeeeeeeeeeeeecccccccccccccccccccccccdddddddddddddda
accccccccccccccccccccccccceeeeeeefggggggggggfqqqfnmfffffffffffffffffffffffffffffffffeeehhhheeeeeeeeeeeeeeeeeeeeeccccccccccccccccccccccddddddddddddddda
accccccccccccccccccccccccceeeeeeefffffggfffffqqqfggfgggggggggfggggvggggggggggggggggfeehhhhhheeeeeeeeeeeeeeeeeeecccccccccccccccccccccccddddddddddddddda
accccccccccccccccccccccccceeeeeeefggggggggggfggggggfgggggggggfggggkggggggggggggggggwhhhhhhhhheeeeeeeeeeeeeeeeccccccccccccccccccccccccdddddddddddddddda
accccccccccccccccccccccccceeeeeeefggggggggggfggggggfgggggggggfggggfggggggggggggggggxhhhhhhhhheeeeeeeeeeeeeeecccccccccccccccccccccccccdddddddddddddddda
accccccccccccccccccccccccceeeeeeefgggggggggggggggggfgggggggggfggggffffffgggfffnmfyyfeehhhhhhheeeeeeeeeeeeecccccccccccccccccccccccccccdddddddddddddddda
accccccccccccccccccccccccceeeeeeefgggggggggggggggggfgggggggggfggggfggggfffffggggfiifeeeehhhhheeeeeeeeeeeeeccccccccccccccccccccccccccddddddddddddddddda
accccccccccccccccccccccccceeeeeeefggggggggggffffgggfgggggggggfggggfggggfzzzfggggfiifeeeehhhheeeeeeeeeeeeeeccccccccccccccccccccccccccddddddddddddddddda
accccccccccccccccccccccccceeeeeeefggggggggggffffgggfgggggggggfggggfggggfzzzfggggfiifeeeehhhheeeeeeeeeeeeeeccccccccccccccccccccccccccddddddddddddddddda
accccccccccccccccccccccccceeeeeeefggggggggggfAAfgggfgggggggggfggggfggggfzzzfggggfqqfeeeehhhheeeeeeeeeeeeeccccccccccccccccccccccccccdddddddddddddddddda
accccccccccccccccccccccccceeeeeeefggggggggggfggfgggfgggggggggfggggffsjffzzzfggggfrrfeeeehhhheeeeeeeeeeeeecccccccccccccccccccccccccddddddddddddddddddda
accccccccccccccccccccccccceeeeeeefggggggggggfggggggfgggggggggvgggggggggwzzzvggggffffeeeeehhhheeeeeeeeeeeeccccccccccccccccccccccccccdddddddddddddddddda
accccccccccccccccccccccccceeeeeeefggggggggggfggggggfgggggggggkgggggggggxzzzkggggffffeeeeehhhhheeeeeeeeeeccccccccccccccccccccccccccddddddddddddddddddda
accccccccccccccccccccccccceeeeeeefffffffffffffffffffffffffffffffffffffffzzzfffffffffeeeehhhhhheeeeeeeeeecccccccccccccccccccccccccdddddddddddddddddddda
accccccccccccccccccccccccceeeeeeeeeeeeeeeeeeeeeeeeeeeeeeeeeeeeeeeeeeeeezzzzzeeeeeeeeeeeehhhhheeeeeeeeeeeccccccccccccccccccccccccccddddddddddddddddddda
accccccccccccccccccccccccceeeeeeeeeeeeeeeeeeeeeeeeeeeeeeeeeeeeeeeeeeeeeezzzeeeeeeeeeeeeehhhhheeeeeeeeeeecccccccccccccccccccccccccdddddddddddddddddddda
accccccccccccccccccccccccceeeeeeeeeeeeeeeeeeeeeeeeeeeeeeeeeeeeeeeeeeeeehhhhhhhhheeeeeeehhhhhheeeeeeeeeeeecccccccccccccccccccccccddddddddddddddddddddda
accccccccccccccccccccccccceeeeeeeeeeeeeeeeeeeeeeeeeeeeeeeeeeeeeeeeeeeeehhhhhhhhhhhhhhhhhhhhhheeeeeeeeeeeeccccccccccccccccccccccccdddddddddddddddddddda
accccccccccccccccccccccccceeeeeeeeeeeeeeeeeeeeeeeeeeeeeeeeeeeeeeeeeeeeeehhhhhhhhhhhhhhhhhhhhheeeeeeeeeeeecccccccccccccccccccccccddddddddddddddddddddda
accccccccccccccccccccccccceeeeeeeeeeeeeeeeeeeeeeeeeeeeeeeeeeeeeeeeeeeeeeeeeehhhhhhhhhhhhhhhhheeeeeeeeeeeeecccccccccccccccccccccccdddddddddddddddddddda
accccccccccccccccccccccccccccccccccccccccccccccccccccceeeeeeeeeeeeeeeeeeeeeeeehhhhhhhhhhhhhhheeeeeeeeeeeeeecccccccccccccccccccccddddddddddddddddddddda
accccccccccccccccccccccccccccccccccccccccccccccccccccceeeeeeeeeeeeeeeeeeeeeeeeeeeeeeeeeehhhhheeeeeeeeeeeeecccccccccccccccccccccccdddddddddddddddddddda
acccccccccccccccccccccccccccccccccccccccccccccccccccccccceeeeeeeeeeeeeeeeeeeeeeeeeeeeeeeehhhhheeeeeeeeeeeeccecccccccccccccccccccddddddddddddddddddddda
acccccccccccccccccccccccccccccccccccccccccccccccccccccccccceeeeeeeeeeeeeeeeeeeeeeeeeeeeeehhhhheeeeeeeeeeeeececccccccccccccccccccddddddddddddddddddddda
accccccccccccccccccccccccccccccccccccccccccccccccccccccccccccceeeeeeeeeeeeeeeeeeeeeeeeeeehhhheeeeeeeeeeeeeeeecccccccccccccccccccddddddddddddddddddddda
acccccccccccccccccccccccccccccccccccccccccccccccccccccccccccccccceeeeeeeeeeeeeeeeeeeeeeeehhhheeeeeeeeeeeeeeeecccccccccccccccccccddddddddddddddddddddda
acccccccccccccccccccccccccccccccccccccccccccccccccccccccccccccccccceeeeeeeeeeeeeeeeeeeeeehhhheeeeeeeeeeeeeeeeccccccccccccccccccccdddddddddddddddddddda
accccccccccccccccccccccccccccccccccccccccccccccccccccccccccccccccccccccceeeeeeeeeeeeeeeeehhheeeeeeeeeeeeeeeeeccecccccccccccccccccdddddddddddddddddddda
accccccccccccccccccccccccccccccccccccccccccccccccccccccccccccccccccccccceeeeeeeeeeeeeeeeehhhheeeeeeeeeeeeeeeeccccccccccccccccccccdddddddddddddddddddda
acccccccccccccccccccccccccccccccccccccccccccccccccccccccccccccccccccccccceeeeeeeeeeeeeeehhhhheeeeeeeeeeeeeeeeceeccccccccccccccccddddddddddddddddddddda
acccccccccccccccccccccccccccccccccccccccccccccccccccccccccccccccccccccccceeeeeeeeeeeeeeehhhhheeeeeeeeeeeeeeeeceecccccccccccccccccdddddddddddddddddddda
accccccccccccccccccccccccccccccccccccccccccccccccccccccccccccccccccccccccceeeeeeeeeeeeehhhhhheeeeeeeeeeeeeeeeeeccccccccccccccccccdddddddddddddddddddda
accccccccccccccccccccccccccccccccccccccccccccccccccccccccccccccccccccccccccceeeeeeeeeehhhhhheeeeeeeeeeeeeeeeeceecccccccccccccccccdddddddddddddddddddda
accccccccccccccccccccccccccccccccccccccccccccccccccccccccccccccccccccccccccccccceeeeehhhhhheeeeeeeeeeeeeeeeeeececcccccccccccccccccddddddddddddddddddda
accccccccccccccccccccccccccccccccccccccccccccccccccccccccccccccccccccccccccccccceeehhhhhhhheeeeeeeeeeeeeeeeeeececccccccccccccccccccdddddddddddddddddda
acccccccccccccccccccccccccccccccccccccccccccccccccccccccccccccccccccccccccccccccccchhhhhhheeeeeeeeeeeeeeeeeeeeeeccccccccccccccccccccddddddddddddddddda
acccccccccccccccccccccccccccccccccccccccccccccccccccccccccccccccccccccccccccccccchhhhhhhheeeeeeeeeeeeeeeeeeeeeeeceeeccccccccccccccccddddddddddddddddda
acccccccccccccccccccccccccccccccccccccccccccccccccccccccccccccccccccccccccccccccchhhhhheeeeeeeeeeeeeeeeeeeeeeeeeeceecccccccccccccccccdddddddddddddddda
accccccccccccccccccccccccccccccccccccccccccccccccccccccccccccccccccccccccccccccchhhhhhheeeeecceeeeeeeeeeeeeeeeeeeeeccccccccccccccccccccdddddddddddddda
accccccccccccccccccccccccccccccccccccccccccccccccccccccccccccccccccccccccccccchhhhhhhheeeeeeeeeceeeeeeeeeeeeeeeeeeeeccccccccccccccccccccddddddddddddda
acccccccccccccccccccccccccccccccccccccccccccccccccccccccccccccccccccccccccccchhhhhhhhccccccccceeccceeeeeeeeeeeeeeeeeeceeeeccccccccccccccccddddddddddda
accccccccccccccccccccccccccccccccccccccccccccccccccccccccccccccccccccccccccchhhhhhhhcccccccccccccececeeeeeeeeeeeeeeeeeeececccccccccccccccccdddddddddda
accccccccccccccccccccccccccccccccccccccccccccccccccccccccccccccccccccccccccchhhhhhhcccccccccccccccceeeeeeceeeeeeeeeeeeeeeeeceecccccccccccccccdddddddda
accccccccccccccccccccccccccccccccccccccccccccccccccccccccccccccccccccccccccchhhhhhhcccccccccccccccccccececcccceeeeeeeeeeeeeeeececccccccccccccccdddddda
acccccccccccccccccccccccccccccccccccccccccccccccccccccccccccccccccccccccccchhhhhhhccccccccccccccccccccceceeccceeeeeeeeeeeeeeeeeeccccccccccccccccddddda
acccccccccccccccccccccccccccccccccccccccccccccccccccccccccccccccccccccccccchhhhhhcccccccccccccccccccccccccececceeeeeeeeeeeeeeeeeecccccccccccccccccddda
acccccccccccccccccccccccccccccccccccccccccccccccccccccccccccccccccccccccccchhhhhhccccccccccccccccccccccccccceceeceeeeeeeeeeeeeeeeccccccccccccccccceeea
accccccccccccccccccccccccccccccccccccccccccccccccccccccccccccccccccccccccchhhhhhcccccccccccccccccccccccccccccceececceeeeeeeeeeeeecccccccccccccccceeeeB
accccccccccccccccccccccccccccccccccccccccccccccccccccccccccccccccccccccccchhhhhhccccccccccccccccccccccccccccccccceceeeeeeeeeeeeeeeeccccccccccccceeeeeC
acccccccccccccccccccccccccccccccccccccccccccccccccccccccccccccccccccccccchhhhhhccccccccccccccccccccccccccccccccccceceeeeeeeeeeeeeeeccccccccccceeeeeeeD
acccccccccccccccccccccccccccccccccccccccccccccccccccccccccccccccccccccccchhhhhhccccccccccccccccccccccccccccccccccccceceeeeeeeeeeeeeccccccccceeeeeeeeeE
accccccccccccccccccccccccccccccccccccccccccccccccccccccccccccccccccccccchhhhhhcccccccccccccccccccccccccccccccccccccceecceeeeeeeeeeeeeeeeccceeeeeeeeFea
accccccccccccccccccccccccccccccccccccccccccccccccccccccccccccccccccccccchhhhhhhcccccccccccccccccccccccccccccccccccccccceceeeeeeeeeeeeeeecceeeeeeFeeFea
acccccccccccccccccccccccccccccccccccccccccccccccccccccccccccccccccccccchhhhhhcccccccccccccccccccccccccccccccccccccccccceeeeeeeeeeeeeeeeeeeeeeeeFFFFFFa
acccccccccccccccccccccccccccccccccccccccccccccccccccccccccccccccccccccchhhhhhhccccccccccccccccccccccccccccccccccccccccceeeeeeeeeeeeeeeeeeeeeFFFFFFFFFa
acccccccccccccccccccccccccccccccccccccccccccccccccccccccccccccccccccccchhhhhhhccccccccccccccccccccccccccccccccccccccccceeeeeeeeeeeeeeeeeeeFeeFFFFFFFFa
accccccccccccccccccccccccccccccccccccccccccccccccccccccccccccccccccccchhhhhhhhccccccccccccccccccccccccccccccccccccccccceeeeeeeeeeeeeeeeeeFFFFFFFFFFFFa
accccccccccccccccccccccccccccccccccccccccccccccccccccccccccccccccccccchhhhhhhcccccccccccccccccccccccccccccccccccccccccccceeeeeeeeeeeeeeeeFFFFFFFFFFFFa
acccccccccccccccccccccccccccccccccccccccccccccccccccccccccccccccccccchhhhhhhhcccccccccccccccccccccccccccccccccccccccccccceeeeeeeeeeeeeeeFFFFFFFFFFFFFa
acccccccccccccccccccccccccccccccccccccccccccccccccccccccccccccccccccchhhhhhhcccccccccccccccccccccccccccccccccccccccccccccccccceeeeeeeeeFFFFFFFFFFFFFFa
acccccccccccccccccccccccccccccccccccccccccccccccccccccccccccccccccccchhhhhhhcccccccccccccccccccccccccccccccccccccccccccccccccceeeeeeeeeFFFFFFFFFFFFFFa
acccccccccccccccccccccccccccccccccccccccccccccccccccccccccccccccccccchhhhhhhcccccccccccccccccccccccccccccccccccccccccccccccccceeeeeeeeeeFFFFFFFFFFFFFa
acccccccccccccccccccccccccccccccccccccccccccccccccccccccccccccccccccchhhhhhhcccccccccccccccccccccccccccccccccccccccccccccccccceeeeeeeeeeeeeeeeeeeeeeea
accccccccccccccccccccccccccccccccccccccccccccccccccccccccccccccccccccchhhhhhcccccccccccccccccccccccccccccccccccccccccccccccccceeeeeeeeeeeeeeeeeeeeeeea
GaaaaaaaaaaaaaaaaaaaaaaaaaaaaaaaaaaaaaaaaaaaaaaaaaaaaaaaaaaaaaaaaaaaaaaaHIJKaaaaaaaaaaaaaaaaaaaaaaaaaaaaaaaaaaaaaaaaaaaaaaaaaaaaaaaaaaaaaaaaaaaaaaaaaa
"}
