"a" = (/turf/unsimulated/wall/ice,/area/winterstorm)
"b" = (/turf/genturf,/area/winterstorm)
"c" = (/turf/simulated/open,/area/winterstorm)
"d" = (/turf/simulated/floor/dirt,/area/winterstorm)
"e" = (/turf/simulated/floor/beach/water,/area/winterstorm)
"f" = (/obj/effect/decal/cleanable/vomit,/turf/simulated/floor/dirt,/area/winterstorm)
"g" = (/obj/effect/decal/cleanable/blood/drip,/turf/simulated/floor/dirt,/area/winterstorm)
"h" = (/obj/random/tool,/turf/simulated/floor/dirt,/area/winterstorm)
"i" = (/obj/item/weapon/paper/crumpled,/turf/simulated/floor/dirt,/area/winterstorm)
"j" = (/obj/structure/closet/crate/trashcart,/obj/item/weapon/bikehorn/rubberducky,/obj/item/weapon/bedsheet,/turf/simulated/floor/dirt,/area/winterstorm)
"k" = (/obj/machinery/washing_machine,/turf/simulated/floor/dirt,/area/winterstorm)
"l" = (/obj/travellocation{id = "34eastwest12"},/turf/simulated/floor/snow,/area/winterstorm)
"m" = (/obj/random/junk,/turf/simulated/floor/dirt,/area/winterstorm)
"n" = (/obj/item/weapon/reagent_containers/syringe/drugs,/turf/simulated/floor/dirt,/area/winterstorm)
"o" = (/obj/travellocation{id = "34eastwest13"},/turf/simulated/floor/snow,/area/winterstorm)
"p" = (/obj/random/action_figure,/turf/simulated/floor/dirt,/area/winterstorm)
"q" = (/obj/item/weapon/paper/crumpled/bloody,/turf/simulated/floor/dirt,/area/winterstorm)
"r" = (/obj/item/weapon/material/shard,/turf/simulated/floor/dirt,/area/winterstorm)
"s" = (/obj/item/weapon/material/kitchen/utensil/knife,/obj/item/weapon/storage/bag/trash,/turf/simulated/floor/beach/water,/area/winterstorm)
"t" = (/obj/item/weapon/storage/pill_bottle/happy,/obj/item/weapon/reagent_containers/pill/happy,/turf/simulated/floor/dirt,/area/winterstorm)
"u" = (/obj/item/weapon/material/kitchen/utensil/fork,/obj/effect/decal/cleanable/blood,/turf/simulated/floor/dirt,/area/winterstorm)
"v" = (/obj/item/weapon/reagent_containers/pill/happy,/turf/simulated/floor/beach/water,/area/winterstorm)
"w" = (/obj/effect/decal/cleanable/blood,/turf/simulated/floor/dirt,/area/winterstorm)
"x" = (/obj/item/weapon/reagent_containers/food/snacks/no_raisin,/turf/simulated/floor/beach/water,/area/winterstorm)
"y" = (/obj/structure/ladder,/turf/simulated/floor/dirt,/area/winterstorm)
"z" = (/obj/structure/lattice,/turf/simulated/open,/area/winterstorm)
"A" = (/obj/effect/landmark/terrain_generator,/turf/unsimulated/wall/ice,/area/winterstorm)
"B" = (/turf/unsimulated/wall,/area/winterstorm/mystery_zone)
"C" = (/turf/simulated/floor/snow,/area/winterstorm)
"D" = (/obj/travellocation{id = "34eastwest4"},/turf/simulated/floor/snow,/area/winterstorm)
"E" = (/obj/travellocation{id = "34eastwest5"},/turf/simulated/floor/snow,/area/winterstorm)
"F" = (/obj/travellocation{id = "34eastwest6"},/turf/simulated/floor/snow,/area/winterstorm)
"G" = (/obj/travellocation{id = "34eastwest7"},/turf/simulated/floor/snow,/area/winterstorm)

(1,1,1) = {"
aaaaaaaaaaaaaaaaaaaaaaaaaaaaaaaaaaaaaaaaaaaaaaaaaaaaaaaaaaaaaaaaaaaaaaaaaaaaaaaaaaaaaaaaaaaaaaaaaaaaaaaaaaaaaaaaaaaaaaaaabbbbbbbbbbbbbbbbbbccccccccccc
aaaaaaaaaaaaaaaaaaaaaaaaaaaaaaaaaaaaaaaaaaaaaaaaaaaaaaaaaaaaaaaaaaaaaaaaaaaaaaaaaaaaaaaaaaaaaaaaaaaaaaaaaaaaaaaaaaaaaaaaaabbbbbbbbbbbbbbbbbccccccccccc
aaaaaaaaaaaaaaaaaaaaaaaaaaaaaaaaaaaaaaaaaaaaaaaaaaaaaaaaaaaaaaaaaaaaaaaaaaaaaaaaaaaaaaaaaaaaaaaaaaaaaaaaaaaaaaaaaaaaaaaaaaabbbbbbbbbbbbbbbbbcccccccccc
aaaaaaaaaaaaaaaaaaaaaaaaaaaaaaaaaaaaaaaaaaaaaaaaaaaaaaaaaaaaaaaaaaaaaaaaaaaaaaaaaaaaaaaaaaaaaaaaaaaaaaaaaaaaaaaaaaaaaaaaaaabbbbbbbbbbbbbbbbbcccccccccc
aaaaaaaaaaaaaaaaaaaaaaaaaaaaaaaaaaaaaaaaaaaaaaaaaaaaaaaaaaaaaaaaaaaaaaaaaaaaaaaaaaaaaaaaaaaaaaaaaaaaaaaaaaaaaaaaaaaaaaaaaaaabbbbbbbbbbbbbbbbbccccccccc
aaaaaaaaaaaaaaaaaaaaaaaaaaaaaaaaaaaaaaaaaaaaaaaaaaaaaaaaaaaaaaaaaaaaaaaaaaaaaaaaaaaaaaaaaaaaaaaaaaaaaaaaaaaaaaaaaaaaaaaaaaaaabbbbbbbbbbbbbbbbccccccccc
aaaaaaaaaaaaaaaaaaaaaaaaaaaaaaaaaaaaaaaaaaaaaaaaaaaaaaaaaaaaaaaaaaaaaaaaaaaaaaaaaaaaaaaaaaaaaaaaaaaaaaaaaaaaaaaaaaaaaaaaaaaaabbbbbbbbbbbbbbbbccccccccc
aaaaaaaaaaaaaaaaaaaaaaaaaaaaaaaaaaaaaaaaaaaaaaaaaaaaaaaaaaaaaaaaaaaaaaaaaaaaaaaaaaaaaaaaaaaaaaaaaaaaaaaaaaaaaaaaaaaaaaaaaaaaaabbbbbbbbbbbbbbbbcccccccc
aaaaaaaaaaaaaaaaaaaaaaaaaaaaaaaaaaaaaaaaaaaaaaaaaaaaaaaaaaaaaaaaaaaaaaaaaaaaaaaaaaaaaaaaaaaaaaaaaaaaaaaaaaaaaaaaaaaaaaaaaaaaaabbbbbbbbbbbbbbbbcccccccc
aaaaaaaaaaaaaaaaaaaaaaaaaaaaaaaaaaaaaaaaaaaaaaaaaaaaaaaaaaaaaaaaaaaaaaaaaaaaaaaaaaaaaaaaaaaaaaaaaaaaaaaaaaaaaaaaaaaaaaaaaaaaaabbbbbbbbbbbbbbbbcccccccc
aaaaaaaaaaaaaaaaaaaaaaaaaaaaaaaaaaaaaaaaaaaaaaaaaaaaaaaaaaaaaaaaaaaaaaaaaaaaaaaaaaaaaaaaaaaaaaaaaaaaaaaaaaaaaaaaaaaaaaaaaaaaaaabbbbbbbbbbbbbbbcccccccc
aaaaaaaaaaaaaaaaaaaaaaaaaddddddddddddddddccccccccccccccccccccccccccccccccccccccaaaaaaaaaaaaaaaaaaaaaaaaaaaaaaaaaaaaaaaaaaaaaaaaaabbbbbbbbbbbbbcccccccc
aaaaaaaaaaaaaaaaaaaaaaaaaddddddddddddddddccccccccccccccccccccccccccccccccccccccaaaaaaaaaaaaaaaaaaaaaaaaaaaaaaaaaaaaaaaaaaaaaaaaaaabbbbbbbbbbbbbccccccc
aaaaaaaaaaaaaaaaaaaaaaaaaddddddddddddddddccccccccccccccccccccccccccccccccccccccaaaaaaaaaaaaaaaaaaaaaaaaaaaaaaaaaaaaaaaaaaaaaaaaaabbbbbbbbbbbbbbccccccc
aaaaaaaaaaaaaaaaaaaaaaaaaddddddddddddddddccccccccccccccccccccccccccccccccccccccaaaaaaaaaaaaaaaaaaaaaaaaaaaaaaaaaaaaaaaaaaaaaaaaabbbbbbbbbbbbbbbccccccc
aaaaaaaaaaaaaaaaaaaaaaaaaddddaaaaaaaaaaaaccccccccccccccccccccccccccccccccccccccaaaaaaaaaaaaaaaaaaaaaaaaaaaaaaaaaaaaaaaaaaaaaaaaabbbbbbbbbbbbbbbccccccc
aaaaaaaaaaaaaaaaaaaaaaaaaddddaaaaaaaaaaaaccccccccccccccccccccccccccccccccccccccaaaaaaaaaaaaaaaaaaaaaaaaaaaaaaaaaaaaaaaaaaaaaaaaabbbbbbbbbbbbbbcccccccc
aaaaaaaaaaaaaaaaaaaaaaaaaddddaaaaaaaaaaaaaaaaeeeeeaaaaaaaeeeeaaaaaaaaaaaaeeeeaaaaaaaaaaaaaaaaaaaaaaaaaaaaaaaaaaaaaaaaaaaaaaaaaaabbbbbbbbbbbbbbcccccccc
aaaaaaaaaaaaaaaaaaaaaaaaaddddaaaaaaaaaaaaaaaaeeeeeaaaaaaaeeeeaaaaaaaaaaaaeeeeaaaaaaaaaaaaaaaaaaaaaaaaaaaaaaaaaaaaaaaaaaaaaaaaaaabbbbbbbbbbbbbbcccccccc
aaaaaaaaaaaaaaaaaaaaaaaaaddddaaaaaaaaaaaaaaaaeeeeeaaaaaaaeeeeaaaaaaaaaaaaeeeedaaaaaaaaaaaaaaaaaaaaaaaaaaaaaaaaaaaaaaaaaaaaaaaaabbbbbbbbbbbbbbbcccccccc
aaaaaaaaaaaaaaaaaaaaaaaaaddddaaaaaaaaaaaaaaaaeeeeeaaaaaaaeeeeaaaaaaaaaaaaeeeedfdddaaaaaaaaaaaaaaaaaaaaaaaaaaaaaaaaaaaaaaaaaaaaabbbbbbbbbbbbbbbcccccccc
aaaaaaaaaaaaaaaaaaaaaaaaaddddaaaaaaaaaaaaaaaaeeeeeaaaaaaaeeeeaaaaaaaaaaaaeeeeaddgdgddaaaaaaaaaaaaaaaaaaaaaaaaaaaaaaaaaaaaaaaaaabbbbbbbbbbbbbbbcccccccc
aaaaaaaaaaaaaaaaaaaaaaaaaddddaaaaaaaaaaaaaaaaeeeeeaaaaaaaeeeeaaaaaaaaaaaaeeeeaaaaddgdaaaaaaaaaaaaaaaaaaaaaaaaaaaaaaaaaaaaaaaaaabbbbbbbbbbbbbbbcccccccc
aaaaaaaaaaaaaaaaaaaaaaaaaddddaaaaaaaaaaaaaaaaeeeeeaaaaaaaeeeeaaaaaaaaaaaaeeeeaaaaadddaaaaaaaaaaaaaaaaaaaaaaaaaaaaaaaaaaaaaaaaaabbbbbbbbbbbbbbccccccccc
aaaaaaaaaaaaaaaaaaaaaaaaaddddaaaaaaaaaaaaaaaaeeeeeaaaaaaaeeeeaaaaaaaaaaaaeeeeaaaaaadgdaaaaaaaaaaaaaaaaaaaaaaaaaaaaaaaaaaaaaaaaabbbbbbbbbbbbbbccccccccc
aaaaaaaaaaaaaaaaaaaaaaaaaddddaaaaaaaaaaaaaaaaeeeeeaaaaaaaeeeeaaaaaaaaaaaaeeeeaaaaaaagddaaaaaaaaaaaaaaaaaaaaaaaaaaaaaaaaaaaaaaaabbbbbbbbbbbbbbccccccccc
aaaaddddddaaaaaaaaaaaaaaaddddaaaaaaaaaaaaaaaaeeeeeaaaaaaaeeeeaaaaaaaaaaaaeeeeaaaaaaadcdaaaaaaaaaaaaaaaaaaaaaaaaaaaaaaaaaaaaaaaabbbbbbbbbbbbbbccccccccc
aaaadddddddddddddddddddhddiddddddddddddddjddkeeeeeaaaaaaaeeeeaaaaaaaaaaaaeeeeaaaaaaadcddaaaaaaaaaaaaaaaaaaaaaaaaaaaaaaaaaaaaaaabbbbbbbbbbbbbbccccccccc
lddddddddddddddddddddmddddmdddddddddddddddnddeeeeedddddddeeeeaaaaaaaaaaaaeeeeaaaaaaaddddddaaaaaaaaaaaaaaaaaaaaaaaaaaaaaaaaaaaaabbbbbbbbbbbbbbccccccccc
oddddddddpdddmdddqddddddddddrddddddddddddddddeeeesddtudddeeeeaaaaaaaaaaaaeeeeaaaaaaaaaddddaaaaaaaaaaaaaaaaaaaaaaaaaaaaaaaaaaaaabbbbbbbbbbbbbbccccccccc
aaaaddddddddddmddddddddddddddddddddddddddddddveeeeaaagaaaeeeeaaaaaaaaaaaaeeeeaaaaaaaaaddddaaaaaaaaaaaaaaaaaaaaaaaaaaaaaaaaaaaabbbbbbbbbbbbbbbccccccccc
aaaaddddddaaaaaaaaaaaaaaaaaaaaaaaaaaaaaaaaaaaeeeeeaaadaaaeeeeaaaaaaaaaaaaeeeeaaaaaaaaaddddaaaaaaaaaaaaaaaaaaaaaaaaaaaaaaaaaaabbbbbbbbbbbbbbbcccccccccc
aaaaaaaaaaaaaaaaaaaaaaaaaaaaaaaaaaaaaaaaaaaaaeeeeeaaadaaaeeeeaaaaaaaaaaaaeeeeaaaaaaaaaadddaaaaaaaaaaaaaaaaaaaaaaaaaaaaaaaaaaabbbbbbbbbbbbbbbcccccccccc
aaaaaaaaaaaaaaaaaaaaaaaaaaaaaaaaaaaaaaaaaaaaaeeeeeaaadaaaeeeeaaaaaaaaaaaaeeeeaaaaaaaaaadddcaaaaaaaaaaaaaaaaaaaaaaaaaaaaaaaaabbbbbbbbbbbbbbbbcccccccccc
aaaaaaaaaaaaaaaaaaaaaaaaaaaaaaaaaaaaaaaaaaaaaeeeeeaaagaaaeeeeaaaaaaaaaaaaeeeeaaaaaaaaaaadddaaaaaaaaaaaaaaaaaaaaaaaaaaaaaaaabbbbbbbbbbbbbbbbbcccccccccc
aaaaaaaaaaaaaaaaaaaaaaaaaaaaaaaaaaaaaaaaaaaaaeeeeeaaadaaaeeeeaaaaaaaaaaaaeeeeaaaaaaaaaaddddaaaaaaaaaaaaaaaaaaaaaaaaaaaaaaaabbbbbbbbbbbbbbbbbcccccccccc
aaaaaaaaaaaaaaaaaaaaaaaaaaaaaaaaaaaaaaaaaaaaacccccaaagaaaeeeeaaaaaaaaaaaaeeeeaaaaaaaaaaddcddaaaaaaaaaaaaaaaaaaaaaaaaaaaaaabbbbbbbbbbbbbbbbbccccccccccc
aaaaaaaaaaaaaaaaaaaaaaaaaaaaaaaaaaaaaaaaaaaaacccccaaadaaaeeeeaaaaaaaaaaaaeeeeaaaaaaaaaaaddddaaaaaaaaaaaaaaaaaaaaaaaaaaaaaabbbbbbbbbbbbbbbbbccccccccccc
aaaaaaaaaaaaaaaaaaaaaaaaaaaaaaaaaaaaaaaaaaaaacccccaaadaaaeeeeaaaaaaaaaaaaeeeeaaaaaaaaaaaddddaaaaaaaaaaaaaaaaaaaaaaaaaaaaaabbbbbbbbbbbbbbbbcccccccccccc
aaaaaaaaaaaaaaaaaaaaaaaaaaaaaaaaaaaaaaaaaaaaacccccaaadaaaeeeeaaaaaaaaaaaaeeeeaaaaaaaaaaaddddaaaaaaaaaaaaaaaaaaaaaaaaaaaaabbbbbbbbbbbbbbbbccccccccccccc
aaaaaaaaaaaaaaaaaaaaaaaaaaaaaaaaaaaaaaaaaaaaacccccaaagaaaeeeeaaaaaaaaaaaaeeeeaaaaaaaaaadddddaaaaaaaaaaaaaaaaaaaaaaaaaaaaabbbbbbbbbbbbbbbbccccccccccccc
aaaaaaaaaaaaaaaaaaaaaaaaaaaaaaaaaaaaaaaaaaaaacccccaaadaaaeeeeaaaaaaaaaaaaeeeeaaaaaaaaaaddddaaaaaaaaaaaaaaaaaaaaaaaaaaaaaabbbbbbbbbbbbbbbbccccccccccccc
aaaaaaaaaaaaaaaaaaaaaaaaaaaaaaaaaaaaaaaaaaaaaeeeeeaaadaaaeeeeaaaaaaaaaaaaeeeeaaaaaaaaaadcddaaaaaaaaaaaaaaaaaaaaaaaaaaaaaabbbbbbbbbbbbbbbbccccccccccccc
aaaaaaaaaaaaaaaaaaaaaaaaaaaaaaaaaaaaaaaaaaaaaeeeeeaaadaaaeeeeaaaaaaaaaaaaeeeeaaaaaaaaaaadddaaaaaaaaaaaaaaaaaaaaaaaaaaaaaabbbbbbbbbbbbbbbbccccccccccccc
aaaaaaaaaaaaaaaaaaaaaaaaaaaaaaaaaaaaaaaaaaaaaeeeeeaaadaaaeeeeaaaaaaaaaaaaeeeeaaaaaaaaaaadddaaaaaaaaaaaaaaaaaaaaaaaaaaaaabbbbbbbbbbbbbbbbbccccccccccccc
aaaaaaaaaaaaaaaaaaaaaaaaaaaaaaaaaaaaaaaaaaaaaeeeeeaaadaaaeeeedddddddddgdfeeeeaaaaaaaaaaaddddaaaaaaaaaaaaaaaaaaaaaaaaaaaabbbbbbbbbbbbbbbbbccccccccccccc
aaaaaaaaaaaaaaaaaaaaaaaaaaaaaaaaaaaaaaaaaaaaaeeeeeaaagddgeeeeddwddddgdddgeeeeaaaaaaaaaaaddddaaaaaaaaaaaaaaaaaaaaaaaaaaaabbbbbbbbbbbbbbbbcccccccccccccc
aaaaaaaaaaaaaaaaaaaaaaaaaaaaaaaaaaaaaaaaaaaaaeeeeeaaafaaaeeeedgdddgddddddeeeeaaaaaaaaaddddddaaaaaaaaaaaaaaaaaaaaaaaaaaaabbbbbbbbbbbbbbbbcccccccccccccc
aaaaaaaaaaaaaaaaaaaaaaaaaaaaaaaaaaaaaaaaaaaaaeeeeeaaadaaaeeeeaaaaaaaaaaaaeeeeaaaaaaaaaddddddaaaaaaaaaaaaaaaaaaaaaaaaaaaabbbbbbbbbbbbbbbbcccccccccccccc
aaaaaaaaaaaaaaaaaaaaaaaaaaaaaaaaaaaaaaaaaaaaaeeeeeaaadaaaeeeeaaaaaaaaaaaaeeeeaaaaaaaaaaddddddaaaaaaaaaaaaaaaaaaaaaaaaaaaabbbbbbbbbbbbbbbcccccccccccccc
aaaaaaaaaaaaaaaaaaaaaaaaaaaaaaaaaaaaaaaaaaaaaeeeeeaaadaaaeeeeaaaaaaaaaaaaeeeeaaaaaaaaaaddddddaaaaaaaaaaaaaaaaaaaaaaaaaaaabbbbbbbbbbbbbbbbccccccccccccc
aaaaaaaaaaaaaaaaaaaaaaaaaaaaaaaaaaaaaaaaaaaaaeeeeeaaadaaaeeeeaaaaaaaaaaaaeeeeaaaaaaaaaddccddddaaaaaaaaaaaaaaaaaaaaaaaaaaaaabbbbbbbbbbbbbbccccccccccccc
aaaaaaaaaaaaaaaaaaaaaaaaaaaaaaaaaaaaaaaaaaaaaeeeeeaaadaaaeeeeaaaaaaaaaaaaeeeeaaaaadddddccccccdaaaaaaaaaaaaaaaaaaaaaaaaaaaaaabbbbbbbbbbbbbccccccccccccc
aaaaaaaaaaaaaaaaaaaaaaaaaaaaaaaaaaaaaaaaaaaaaeeeeeaaadaaaeeeeaaaaaaaaaaaaeeeeaaaddcccccccccccddaaaaaaaaaaaaaaaaaaaaaaaaaaaaaabbbbbbbbbbbbccccccccccccc
aaaaaaaaaaaaaaaaaaaaaaaaaaaaaaaaaaaaaaaaaaaaaeeeeeaaadaaaeeeeaaaaaaaaaaaaeeeeaadcccccccccccccdddaaaaaaaaaaaaaaaaaaaaaaaaaaaaaabbbbbbbbbbbccccccccccccc
aaaaaaaaaaaaaaaaaaaaaaaaaaaaaaaaaaaaaaaaaaaaaeeeeeaaadaaaeeeeaaaaaaaaaaaaeeeeaadddccccccccccccddaaaaaaaaaaaaaaaaaaaaaaaaaaaaaabbbbbbbbbbcccccccccccccc
aaaaaaaaaaaaaaaaaaaaaaaaaaaaaaaaaaaaaaaaaaaaaeeeeeaaadaaaeeeeaaaaaaaaaaaaeeeeaaaaddcccccccccccddaaaaaaaaaaaaaaaaaaaaaaaaaaaaaabbbbbbbbbccccccccccccccc
aaaaaaaaaaaaaaaaaaaaaaaaaaaaaaaaaaaaaaaaaaaaaeeeeedddddddeeeeaaaaaaaaaaaaeeeeaaaadddddccccccccddaaaaaaaaaaaaaaaaaaaaaaaaaaaaaabbbbbbbbbccccccccccccccc
aaaaaaaaaaaaaaaaaaaaaaaaaaaaaaaaaaaaaaaaaaaaaeexeedddddddeeeeaaaaaaaaaaaaeeeeaaaadddddddcccccdddaaaaaaaaaaaaaaaaaaaaaaaaaaaaaabbbbbbbbcccccccccccccccc
aaaaaaaaaaaaaaaaaaaaaaaaaaaaaaaaaaaaaaaaaaaaaeeeeeaadddaaeeeeaaaaaaaaaaaaeeeeaaaaaaaddddddcccdddaaaaaaaaaaaaaaaaaaaaaaaaaaaaabbbbbbbbbcccccccccccccccc
aaaaaaaaaaaaaaaaaaaaaaaaaaaaaaaaaaaaaadddaaaaeeeeeaadddaaaaaaaaaaaaaaaaaaeeeeaaaaaaaadddddddddaaaaaaaaaaaaaaaaaaaaaaaaaaaaaaabbbbbbbbbcccccccccccccccc
aaaaaaaaaaaaaaaaaaaaaaaaaaaaaadddddddddydaaaaeeeeeaadydaaaaaaaaaaaaaaaaaaeeeeaaaaaaaaaadddddddaaaaaaaaaaaaaaaaaaaaaaaaaaaaaabbbbbbbbbccccccccccccccccc
aaaaaaaaaaaaaaaaaaaaaaaaaaaaaadaaaaaaadddaaaaeeeeeaadddaaaaaaaaaaaaaaaaaaeeeeaaaaaaaaaaaaaaaaaaaaaaaaaaaaaaaaaaaaaaaaabbbbbbbbbbbbbbbccccccccccccccccc
aaaaaaaaaaaaaaaaaaaaaaaaaaaaaadaaaaaaaaaaaaaaeeeeeaaaaaaaaaaaaaaaaaaaaaaaeeeeaaaaaaaaaaaaaaaaaaaaaaaaaaaaaaaaaaaaaaaabbbbbbbbbbbbbbbbccccccccccccccccc
aaaaaaaaaaaaaaaaaaaaaaaaaaaaaadaaaaaaaaaaaaaaeeeeeaaaaaaaaaaaaaaaaaaaaaaaeeeeaaaaaaaaaaaaaaaaaaaaaaaaaaaaaaaaaaaaaaabbbbbbbbbbbbbbbbbccccccccccccccccc
aaaaaaaaaaaaaaaaaaaaaaaaaaaaaadaaaaaaaaaaaaaaeeeeeaaaaaaaaaaaaaaaaaaaaaaaeeeeaaaaaaaaaaaaaaaaaaaaaaaaaaaaaaaaaaaaabbbbbbbbbbbbbbbbbbbccccccccccccccccc
aaaaaaaaaaaaaaaaaaaaaaeeeeeeeeeeeeeeeecccccccccccccccccccccccccccccccccccccczcaaaaaaaaaaaaaaaaaaaaaaaaaaaaaaaaaaaabbbbbbbbbbbbbbbbbbcccccccccccccccccc
aaaaaaaaaaaaaaaaaaaaaaeeeeeeeeeeeeeeeecccccccccccccccccccccccccccccccccccccczcaaaaaaaaaaaaaaaaaaaaaaaaaaaaaaaaaaaaabbbbbbbbbbbbbbbbbcccccccccccccccccc
aaaaaaaaaaaaaaaaaaaaaaeeeeeeeeeeeeeeeecccccccccccccccccccccccccccccccccccccczcaaaaaaaaaaaaaaaaaaaaaaaaaaaaaaaaaaaaabbbbbbbbbbbbbbbbbcccccccccccccccccc
aaaaaaaaaaaaaaaaaaaaaaeeeeeeeeeeeeeeeecccccccccccccccccccccccccccccccccccccczcaaaaaaaaaaaaaaaaaaaaaaaaaaaaaaaaaaaaabbbbbbbbbbbbbbbbbbccccccccccccccccc
aaaaaaaaaaaaaaaaaaaaaaeeeeeeeeeeeeeeeecccccccccccccccccccccccccccccccccccccczcaaaaaaaaaaaaaaaaaaaaaaaaaaaaaaaaaaaaabbbbbbbbbbbbbbbbbbccccccccccccccccc
aaaaaaaaaaaaaaaaaaaaaaaaaaaaadddaeeeeeaaaaaaaadddaaaaeeeeeaaaaaaaaaaaaaaaeeeeaaaaaaaaaaaaaaaaaaaaaaaaaaaaaaaaaaaaaabbbbbbbbbbbbbbbbbbccccccccccccccccc
aaaaaaaaaaaaaaaaaaaaaaaaaaaaadddaeeeeeaaaaaaaadddaaaaeeeeeaaaaaaaaaaaaaaaeeeeaaaaaaaaaaaaaaaaaaaaaaaaaaaaaaaaaaaaaabbbbbbbbbbbbbbbbbbbcccccccccccccccc
aaaaaaaaaaaaaaaaaaaaaaaaaaaaadddaeeeeeaaaaaaaadddaaaaeeeeeaaaaaaaaaaaaaaaeeeeaaaaaaaaaaaaaaaaaaaaaaaaaaaaaaaaaaaaaabbbbbbbbbbbbbbbbbbbcccccccccccccccc
aaaaaaaaaaaaaaaaaaaaaaeeeeeeeeeeeeeeeeaaaaaaaadddaaaaeeeeeaaaaaaaaaaaaaaaeeeeaaaaaaaaaaaaaaaaaaaaaaaaaaaaaaaaaaaaaabbbbbbbbbbbbbbbbbbbbccccccccccccccc
aaaaaaaaaaaaaaaaaaaaaaeeeeeeeeeeeeeeeeaaaaaaaadddaaaaeeeeeaaaaaaaaaaaaaaaeeeeaaaaaaaaaaaaaaaaaaaaaaaaaaaaaaaaaaaaaabbbbbbbbbbbbbbbbbbbbccccccccccccccc
aaaaaaaaaaaaaaaaaaaaaaeeeeeeeeeeeeeeeeaaaaaaaadddddddeeeeedddddddddddddddeeeeaaaaaaaaaaaaaaaaaaaaaaaaaaaaaaaaaaaaaaabbbbbbbbbbbbbbbbbbbbcccccccccccccc
aaaaaaaaaaaaaaaaaaaaaaeeeeeeeeeeeeeeeeaaaaaaaadddddddeeeeedddddddddddddddeeeeaaaaaaaaaaaaaaaaaaaaaaaaaaaaaaaaaaaaaaaabbbbbbbbbbbbbbbbbbbcccccccccccccc
aaaaaaaaaaaaaaaaaaaaaaeeeeeeeeeeeeeeeeaaaaaaaadddddddeeeeedddddddddddddddeeeeaaaaaaaaaaaaaaaaaaaaaaaaaaaaaaaaaaaaaaaabbbbbbbbbbbbbbbbbbbcccccccccccccc
aaaaaaaaaaaaaaaaaaaaaaaaaaaaadddaeeeeeaaaaaaaaaaaaaaaeeeeeaaaaaaaaaaaaaaaeeeeaaaaaaaaaaaaaaaaaaaaaaaaaaaaaaaaaaaaaaaabbbbbbbbbbbbbbbbbbccccccccccccccc
aaaaaaaaaaaaaaaaaaaaaaaaaaaaadddaeeeeeaaaaaaaaaaaaaaaeeeeeaaaaaaaaaaaaaaaeeeeaaaaaaaaaaaaaaaaaaaaaaaaaaaaaaaaaaaaaaaabbbbbbbbbbbbbbbbbbccccccccccccccc
aaaaaaaaaaaaaaaaaaaaaaaaaaaaadddaeeeeeaaaaeeeeeeeeeeeeeeeeaaaaaaaaaaaaaaaeeeeaaaaaaaaaaaaaaaaaaaaaaaaaaaaaaaaaaaaaaaaabbbbbbbbbbbbbbbbbbcccccccccccccc
aaaaaaaaaaaaaaaaaaaaaaaaaaaaadddaeeeeeaaaaeeeeeeeeeeeeeeeeaaaaaaaaaaaaaaaeeeeaaaaaaaaaaaaaaaaaaaaaaaaaaaaaaaaaaaaaaaaabbbbbbbbbbbbbbbbbbcccccccccccccc
aaaaaaaaaaaaaaaaaaaaaaaaaaaaadddaeeeeeddddeeeeeeeeeeeeeeeeaaaaaaaaaaaaaaaeeeeaaaaaaaaaaaaaaaaaaaaaaaaaaaaaaaaaaaaaaaaabbbbbbbbbbbbbbbbbbcccccccccccccc
aaaaaaaaaaaaaaaaaaaaaaeeeeeeeeeeeeeeeeaaaaeeeeeeeeeeeeeeeeaaaaaaaaaaaaaaaeeeeaaaaaaaaaaaaaaaaaaaaaaaaaaaaaaaaaaaaaaaaabbbbbbbbbbbbbbbbbbcccccccccccccc
aaaaaaaaaaaaaaaaaaaaaaeeeeeeeeeeeeeeeeaaaaeeeeeeeeeeeeeeeeaaaaaaaaaaaaaaaeeeeaaaaaaaaaaaaaaaaaaaaaaaaaaaaaaaaaaaaaaaaabbbbbbbbbbbbbbbbbbcccccccccccccc
aaaaaaaaaaaaaaaaaaaaaaeeeeeeeeeeeeeeeeaaaaaaaaaaaaaaaeeeeeaaaaaaaaaaaaaaaeeeeaaaaaaaaaaaaaaaaaaaaaaaaaaaaaaaaaaaaaaaaaabbbbbbbbbbbbbbbbbcccccccccccccc
aaaaaaaaaaaaaaaaaaaaaaeeeeeeeeeeeeeeeeaaaaaaaaaaaaaaaeeeeeaaaaaaaaaaaaaaaeeeeaaaaaaaaaaaaaaaaaaaaaaaaaaaaaaaaaaaaaaaaaaabbbbbbbbbbbbbbbbbccccccccccccc
aaaaaaaaaaaaaaaaaaaaaaeeeeeeeeeeeeeeeeaaaaaaaaaaaaaaaeeeeeaaaaaaaaaaaaaaaeeeeaaaaaaaaaaaaaaaaaaaaaaaaaaaaaaaaaaaaaaaaaaabbbbbbbbbbbbbbbbbccccccccccccc
aaaaaaaaaaaaaaaaaaaaaaaaaaaaadddaeeeeeaaaaaaaaaaaaaaaeeeeeaaaaaaaaaaaaaaaeeeeaaaaaaaaaaaaaaaaaaaaaaaaaaaaaaaaaaaaaaaaaaaabbbbbbbbbbbbbbbbccccccccccccc
aaaaaaaaaaaaaaaaaaaaaaaaaaaaadddaeeeeeaaaaaaaaaaaaaaaeeeeeaaaaaaaaaaaaaaaeeeeaaaaaaaaaaaaaaaaaaaaaaaaaaaaaaaaaaaaaaaaaaaabbbbbbbbbbbbbbbbccccccccccccc
aaaaaaaaaaaaaaaaaaaaaaaaaaaaadddaeeeeeaaaaaaaaaaaaaaaeeeeeaaaaaaaaaaaaaaaeeeeaaaaaaaaaaaaaaaaaaaaaaaaaaaaaaaaaaaaaaaaaaaaabbbbbbbbbbbbbbbccccccccccccc
aaaaaaaaaaaaaaaaaaaaaaaaaaaaadddaeeeeeaaaaaaaaaaaaaaaeeeeeaaaaaaaaaaaaaaaeeeeaaaaaaaaaaaaaaaaaaaaaaaaaaaaaaaaaaaaaaaaaaaaabbbbbbbbbbbbbbbccccccccccccc
aaaaaaaaaaaaaaaaaaaacccccccccccccccccccccccccccccccccccccccccccccccccccccccczzzzzzeeeeeeeeeeeeeeeeeeeeaaaaaaaaaaaaaaaaaaaaabbbbbbbbbbbbbbccccccccccccc
aaaaaaaaaaaaaaaaaaaacccccccccccccccccccccccccccccccccccccccccccccccccccccccccccccceeeeeeeeeeeeeeeeeeeeaaaaaaaaaaaaaaaaaaaaaabbbbbbbbbbbbbccccccccccccc
aaaaaaaaaaaaaaaaaaaacccccccccccccccccccccccccccccccccccccccccccccccccccccccccccccceeeeeeeeeeeeeeeeeeeeaaaaaaaaaaaaaaaaaaaaaabbbbbbbbbbbbbccccccccccccc
aaaaaaaaaaaaaaaaaaaacccccccccccccccccccccccccccccccccccccccccccccccccccccccccccccceeeeeeeeeeeeeeeeeeeeaaaaaaaaaaaaaaaaaaaaaabbbbbbbbbbbbbbcccccccccccc
aaaaaaaaaaaaaaaaaaaacccccccccccccccccccccccccccccccccccccccccccccccccccccccccccccceeeeeeeeeeeeeeeeeeeeaaaaaaaaaaaaaaaaaaaaaabbbbbbbbbbbbbbcccccccccccc
aaaaaaaaaaaaaaaaaaaacccccccccccccccccccccccccccccccccccccccccccccccccccccccccccccceeeeeeeeeeeeeeeeeeeeaaaaaaaaaaaaaaaaaaaaaaabbbbbbbbbbbbbcccccccccccc
aaaaaaaaaaaaaaaaaaaaaaaaaaaaaaaaaaaaaaaaaaaaaaaaaaaaaaaaaaaaaaaaaaaaaaaaaaaaaaaaaaaaaaaaaaaaaaaaaaaadaaaaaaaaaaaaaaaaaaaaaaaabbbbbbbbbbbbbcccccccccccc
aaaaaaaaaaaaaaaaaaaaaaaaaaaaaaaaaaaaaaaaaaaaaaaaaaaaaaaaaaaaaaaaaaaaaaaaaaaaaaaaaaaaaaaaaaaaaaaaaaaadaaaaaaaaaaaaaaaaaaaaaaaabbbbbbbbbbbbbcccccccccccc
aaaaaaaaaaaaaaaaaaaaaaaaaaaaaaaaaaaaaaaaaaaaaaaaaaaaaaaaaaaaaaaadddaaaaaaaaaaaaaaaaaaaaaaaaaaaaaaaaadaaaaaaaaaaaaaaaaaaaaaaaaabbbbbbbbbbbbcccccccccccc
aaaaaaaaaaaaaaaaaaaaaaaaaaaaaaaaaaaaaaaaaaaaaaaaaaaaaaaaaaaaaaaadydddddddddddddddddddddddddddddddddddaaaaaaaaaaaaaaaaaaaaaaaaabbbbbbbbbbbbcccccccccccc
aaaaaaaaaaaaaaaaaaaaaaaaaaaaaaaaaaaaaaaaaaaaaaaaaaaaaaaaaaaaaaaadddaaaaaaaaaaaaaaaaaaaaaaaaaaaaaaaaaaaaaaaaaaaaaaaaaaaaaaaaaaaabbbbbbbbbbbcccccccccccc
aaaaaaaaaaaaaaaaaaaaaaaaaaaaaaaaaaaaaaaaaaaaaaaaaaaaaaaaaaaaaaaaaaaaaaaaaaaaaaaaaaaaaaaaaaaaaaaaaaaaaaaaaaaaaaaaaaaaaaaaaaaaaaabbbbbbbbbbbcccccccccccc
aaaaaaaaaaaaaaaaaaaaaaaaaaaaaaaaaaaaaaaaaaaaaaaaaaaaaaaaaaaaaaaaaaaaaaaaaaaaaaaaaaaaaaaaaaaaaaaaaaaaaaaaaaaaaaaaaaaaaaaaaaaaaaaabbbbbbbbbccccccccccccc
aaaaaaaaaaaaaaaaaaaaaaaaaaaaaaaaaaaaaaaaaaaaaaaaaaaaaaaaaaaaaaaaaaaaaaaaaaaaaaaaaaaaaaaaaaaaaaaaaaaaaaabbbbaaaaaaaaaaaaaaaaaaaaabbbbbbbbbccccccccccccc
aaaaaaaaaaaaaaaaaaaaaaaaaaaaaaaaaaaaaaaaaaaaaaaaaaaaaaaaaaaaaaaaaaaaaaaaaaaaaaaaaaaaaaaaaaaaaaaaaaaaabbbbbbbbbbbbbbbbbbbbbaaaaaabbbbbbbbbccccccccccccc
aaaaaaaaaaaaaaaaaaaaaaaaaaaaaaaaaaaaaaaaaaaaaaaaaaaaaaaaaaaaaaaaaaaaaaaaaaaaaaaaaaaaaaaaaaaaaaaaaaabbbbbbbbbbbbbbbbbbbbbbbbbbaaabbbbbbbbbccccccccccccc
aaaaaaaaaaaaaaaaaaaaaaaaaaaaaaaaaaaaaaaaaaaaaaaaaaaaaaaaaaaaaaaaaaaaaaaaaaaaaaaaaaaaaaaaaaaaaaaaaaabbbbbbbbbbbbbbbbbbbbbbbbbbbaabbbbbbbbcccccccccccccc
aaaaaaaaaaaaaaaaaaaaaaaaaaaaaaaaaaaaaaaaaaaaaaaaaaaaaaaaaaaaaaaaaaaaaaaaaaaaaaaaaaaaaaaaaaaaaaaaaaabbbbbbbbbbbbbbbbbbbbbbbbbbbbbbbbbbbbbcccccccccccccc
aaaaaaaaaaaaaaaaaaaaaaaaaaaaaaaaaaaaaaaaaaaaaaaaaaaaaaaaaaaaaaaaaaaaaaaaaaaaaaaaaaaaaaaaaaaaaaaaaaabbbbbbbbbbbbbbbbbbbbbbbbbbbbbbbbbbbbbbccccccccccccc
aaaaaaaaaaaaaaaaaaaaaaaaaaaaaaaaaaaaaaaaaaaaaaaaaaaaaaaaaaaaaaaaaaaaaaaaaaaaaaaaaaaaaaaaaaaaaaaaaaabbbbbbbbbbbbbbbbbbbbbbbbbbbbbbbbbbbbbbccccccccccccc
aaaaaaaaaaaaaaaaaaaaaaaaaaaaaaaaaaaaaaaaaaaaaaaaaaaaaaaaaaaaaaaaaaaaaaaaaaaaaaaaaaaaaaaaaaaaaaaaaaabbbbbbbbbbbbbbbbbbbbbbbbbbbbbbbbbbbbbbccccccccccccc
aaaaaaaaaaaaaaaaaaaaaaaaaaaaaaaaaaaaaaaaaaaaaaaaaaaaaaaaaaaaaaaaaaaaaaaaaaaaaaaaaaaaaaaaaaaaaaaaaaaabbbbbbbbbbbbbbbbbbbbbbbbbbbbbbbbbbbbbccccccccccccc
aaaaaaaaaaaaaaaaaaaaaaaaaaaaaaaaaaaaaaaaaaaaaaaaaaaaaaaaaaaaaaaaaaaaaaaaaaaaaaaaaaaaaaaaaaaaaaaaaaaabbbbbbbbbbbbbbbbbbbbbbbbbbbbbbbbbbbbbccccccccccccc
aaaaaaaaaaaaaaaaaaaaaaaaaaaaaaaaaaaaaaaaaaaaaaaaaaaaaaaaaaaaaaaaaaaaaaaaaaaaaaaaaaaaaaaaaaaaaaaaaaaaabbbbbbbbbbbbbbbbbbbbbbbbbbbbbbbbbbbbccccccccccccc
aaaaaaaaaaaaaaaaaaaaaaaaaaaaaaaaaaaaaaaaaaaaaaaaaaaaaaaaaaaaaaaaaaaaaaaaaaaaaaaaaaaaaaaaaaaaaaaaaaaaaabbbbbbbbbbbbbbbbbbbbbbbbbbbbbbbbbbbccccccccccccc
aaaaaaaaaaaaaaaaaaaaaaaaaaaaaaaaaaaaaaaaaaaaaaaaaaaaaaaaaaaaaaaabaaaaaaaaaaaaaaaaaaaaaaaaaaaaaaaaaaaaaabbbbbbbbbbbbbbbbbbbbbbbbbabbbbbbbcccccccccccccc
aaaaaaaaaaaaaaaaaaaaaaaaaaaaaaaaaaaaaaaaaaaaaaaaaaaaaaaaaaaaaaabbbbabbaaaaaaaaaaaaaaaaaaaaaaaaaaaaaaaaaabbbbbbbbbbbbbbbbaaabbbbbaaabbbbbcccccccccccccc
aaaaaaaaaaaaaaaaaaaaaaaaaaaaaaaaaaaaaaaaaaaaaaaaaaaaaaaaaaaaabbbbbbbbbbbaaaaaaaaaaaaaaaaaaaaaaaaaaaaaaaaabbbbbbbbbbbbbbaaaaabbaaaaaabbbbcccccccccccccc
aaaaaaaaaaaaaaaaaaaaaaaaaaaaaaaaaaaaaaaaaaaaaaaaaaaaaaaaaaaaabbbbbbbbbbbbaaaaaaaaaaaaaaaaaaaaaaaaaaaaaaaaabbbbbbbbbbbbbaaaaaaaaaaaaabbbbcccccccccccccc
aaaaaaaaaaaaaaaaaaaaaaaaaaaaaaaaaaaaaaaaaaaaaaaaaaaaaaaaaaabbbbbbbbbbbbbbaaaaaaaaaaaaaaaaaaaaaaaaaaaaaaaaabbbbbbbbbbbbbaaaaaaaaaaaaabbbccccccccccccccc
aaaaaaaaaaaaaaaaaaaaaaaaaaaaaaaaaaaaaaaaaaaaaaaaaaaaaaaaaabbbbbbbbbbbbbbaaaaaaaaaaaaaaaaaaaaaaaaaaaaaaaaaaabbbbbbbbbbbbaaaaaaaaaaaabbbbccccccccccccccc
aaaaaaaaaaaaaaaaaaaaaaaaaaaaaaaaaaaaaaaaaaaaaaaaaaaaaaaaabbbbbbbbbbbbbaaaaaaaaaaaaaaaaaaaaaaaaaaaaaaaaaaaabbbbbbbbbbbbbbaaaaaaaaaaabbbbccccccccccccccc
aaaaaaaaaaaaaaaaaaaaaaaaaaaaaaaaaaaaaaaaaaaaaaaaaaaaaaaabbbbbbbbbbbbbaaaaaaaaaaaaaaaaaaaaaaaaaaaaaaaaaaaaabbbbbbbbbbbbbbbbbbaaaaaabbbbbccccccccccccccc
aaaaaaaaaAaaaaaaaaaaaaaaaaaaaaaaaaaaaaaaaaaaaaaaaaaaaaabbbbbbbbbbbbbaaaaaaaaaaaaaaaaaaaaaaaaaaaaaaaaaaabbbbbbbbbbbbbbbbbbbbbbbaaabbbbbbccccccccccccccc
aaaaaaaaaaaaaaaaaaaaaaaaaaaaaaaaaaaaaaaaaaaaaaaaaaaaaabbbbbbbbbbbbbaaaaaaaaaaaaaaaaaaaaaaaaaaaaaaaaaabbbbbbbbbbbbbbbbbbbbbbbbbbbbbbbbbbccccccccccccccc
Baaaaaaaaaaaaaaaaaaaaaaaaaaaaaaaaaaaaaaaaaaaaaaaaaaaaabbbbbbbbbbbbaaaaaaaaaaaaaaaaaaaaaaaaaaaaaaaaabbbbbbbbbbbbbbbbbbbbbbbbbbbbbbbbbbbbccccccccccccccc
BCaaaaaaaaaaaaaaaaaaaaaaaaaaaaaaaaaaaaaaaaaaaaaaaaaaaabbbbbbbbbbbbaaaaaaaaaaaaaaaaaaaaaaaaaaaabbbbbbbbbbbbbbbbbbbbbbbbbbbbbbbbbbbbbbbbbccccccccccccccc
BCCaaaaaaaaaaaaaaaaaaaaaaaaaaaaaaaaaaaaaaaaaaaaaaaaaaaabbbbbbbbbbaaaaaaaaaaaaaaaaaaaaaaaaabbbbbbbbbbbbbbbbbbbbbbbbbbbbbbbbbbbbbbbbbbbbbccccccccccccccc
BCCCaaaaaaaaaaaaaaaaaaaaaaaaaaaaaaaaaaaaaaaaaaaaaaaaaaabbbbbbbbbbaaaaaaaaabbbbbaaaaaaaaabbbbbbbbbbbbbbbbbbbbbbbbbbbbbbbbbbbbbbbbbbbbbbcccccccccccccccc
DCCCCaaaaaaaaaaaaaaaaaaaaaaaaaaaaaaaaaaaaaaaaaaaaaaaaabbbbbbbbbbaaaaaaaaabbbbbbbaaaaaaabbbbbbbbbbbbbbbbbbbbbbbbbbbbbbbbbbbbbbbbbbbbbbbcccccccccccccccc
ECCCCaaaaaaaaaaaaaaaaaaaaaaaaaaaaaaaaaaaaaaaaaaaaaaaaabbbbbbbbbbbbaaaaabbbbbbbbbaaaaaabbbbbbbbbbbbbbbbbbbbbbbbbbbbbbbbbbbbbbbbbbbbbbbbcccccccccccccccc
FCCCCbaaaaaaaaaaaaaaaaaaaaaaaaaaaaaaaaaaaaaaaaaaaaaaabbbbbbbbbbbbbaaabbbbbbbbbbbbaaaabbbbbbbbbbbbbbbbbbbbbbbbbbbbbbbbbbbbbbbbbbbbbbbbccccccccccccccccc
GCCCCbbbaaaaaaaaaaaaaaaaaaaaaaaaaaaaaaaaaaaaaaaaaaaabbbbbbbbbbbbbbbbbbbbbbbbbbbbbbaaabbbbbbbbbbbbbbbbbbbbbbbbbbbbbbbbbbbbbbbbbbbbbbbcccccccccccccccccc
BCCCCbbbbbaaaaaaaaaaaaaaaaaaaaaaaaaaaaaaaaaaaaaaaabbbbbbbbbbbbbbbbbbbbbbbbbbbbbbbbbabbbbbbbbbbbbbbbbbbbbbbbbbbbbbbbbbbbbbbbbbbbbbbbccccccccccccccccccc
BCCCbbbbbbbbaaaaaaaaaaaaaaaaaaaaaaabbbbbbbaaaaaaabbbbbbbbbbbbbbbbbbbbbbbbbbbbbbbbbbbbbbbbbbbbbbbbbbbbbbbbbbbbbbbbbbbbbbbbbbbbbbbbccccccccccccccccccccc
BCCCbbbbbbbbbbbbaaaaaaaaabbbbbbbbbbbbbbbbbbbbbbabbbbbbbbbbbbbbbbbbbbbbbbbbbbbbbbbbbbbbbbbbbbbbbbbbbbbbbbbbbbbbbbbbbbbbbbbbbbbbcccccccccccccccccccccccc
BCCbbbbbbbbbbbbbbbbbbbbbbbbbbbbbbbbbbbbbbbbbbbbbbbbbbbbbbbbbbbbbbbbbbbbbbbbbbbbbbbbbbbbbbbbbbbbbbbbbbbbbbbbbbbbbbbbbbbbbbbbccccccccccccccccccccccccccc
BCbbbbbbbbbbbbbbbbbbbbbbbbbbbbbbbbbbbbbbbbbbbbbbbbbbbbbbbbbbbbbbbbbbbbbbcccbcccbbbbbbbbbbbbbbbbbbbbbbbbbbbbbbbbbbbbbbbcccccccccccccccccccccccccccccccc
Bbbbbbbbbbbbbbbbbbbbbbbbbbbbbbbbbbbbbbbbbbbbbbbbbbbbbbbbbbbbbbbbbbbbbbccccccccccccccbbbbbbbbbbbbbbbbbbbbbcccccbccccccccccccccccccccccccccccccccccccccc
ccccbbbbbbbbbbbbbbbbbbbbbbbbbbbbbbbbbbbbbbbbbbbbbbbbbbbbbbbbbbbbbbbbccccccccccccccccccccccccbbbbbbbbbcbccccccccccccccccccccccccccccccccccccccccccccccc
ccccccbbbbbbbbbbbbbbbbbbbbbbbbbbbbbbbbbbbbbbbbbbbbbbbbbbbbbbbbbbbbcccccccccccccccccccccccccccccccccccccccccccccccccccccccccccccccccccccccccccccccccccc
ccccccccccccbbbbbbbbbbbbbbbbbbbbbbbbbbbbbbbbbbbbbbbbbbbbbbcccccccccccccccccccccccccccccccccccccccccccccccccccccccccccccccccccccccccccccccccccccccccccc
ccccccccccccccccccbbbbbbbbbbbbbbbbbbbbbbbbbbbbbbbbbbbbbccccccccccccccccccccccccccccccccccccccccccccccccccccccccccccccccccccccccccccccccccccccccccccccc
ccccccccccccccccccccccccccbbbbbbbbcccccccccccccccccccccccccccccccccccccccccccccccccccccccccccccccccccccccccccccccccccccccccccccccccccccccccccccccccccc
cccccccccccccccccccccccccccccccccccccccccccccccccccccccccccccccccccccccccccccccccccccccccccccccccccccccccccccccccccccccccccccccccccccccccccccccccccccc
cccccccccccccccccccccccccccccccccccccccccccccccccccccccccccccccccccccccccccccccccccccccccccccccccccccccccccccccccccccccccccccccccccccccccccccccccccccc
cccccccccccccccccccccccccccccccccccccccccccccccccccccccccccccccccccccccccccccccccccccccccccccccccccccccccccccccccccccccccccccccccccccccccccccccccccccc
"}
